R 800 800

NO ./textures/no.xpm
SO ./textures/so.xpm









WE ./textures/we.xpm
EA ./textures/ea.xpm
S ./textures/s.xpm
F 111,111,111
C 111,111,111

11111111111111111111
10000000000000000001
10222222222222222201
10000000000000000001
10000000000000000001
10000000000000000001
10000000000000000001
10000000000000000001
10000000000000000001
10000000000100000001
10000000001 10000001
10000000000100000001
10000000000000000001
10000000000000000001
10000000000000000001
10000000000000000001
10000000000000000001
100000000000S0000001
10000000000000000001
11111111111111111111
111111
