R 800 800
EA ./texture/ea.xpm
WE ./texture/we.xpm
F 207,185,151
NO ./texture/no.xpm
SO ./texture/so.xpm
S ./texture/s.xpm
C 0,191,240

11111111111111111111
10000000000000000001
10000000000000000001
10000000000000000001
10000000000000000001
10000000000000000001
10000000000000000001
10000000000000000001
10000000000000000001
11111000000000000001
10001000000000000001
10201000000000000001
10000000000000000001
10111111111111111111
10000000000000001001
11011111111010101101
10000000000010100001
10111011111110111111
100010000000100000W1
11111111111111111111
