R 1920 1080

WE ./texture/we.xpm
EA ./texture/ea.xpm

NO ./texture/no.xpm
SO ./texture/so.xpm
S ./path_to_the_sprite_texture
F 220,100,0
C 225,30,0

1111111111
1000000001111111111
100000000000001101
 111100W00011111111
100000000000001
100001000011111
1000000001
1000000001
1000000001
1111111111
11111111
10000001
11111111
