R 800 800


WE ./texture/we.xpm
EA ./texture/ea.xpm
NO ./texture/no.xpm
SO ./texture/so.xpm
S ./texture/s.xpm
C 0,191,240
F 207,185,151


11111111111111111111111111111111
10000000000000000000000000000001
10000000000000000000000000000001
10000000000000000222220000000001
10000000000000000200020000000001
10000000000000000200020000000001
10000000000000000200020000000001
10000000000000000220220000000001
10000000000000000000000000000001
10000000000000000000000000000001
1000000000000000000N000000000001
10000000000000000000000000000001
10000000000000000000000000000001
10000000000000000000000000000001
10000000000000000000000000000001
10000000000000000000000000000001
10000000000000000000000000000001
11111111111111111111111111111111
