R 802 802



WE ./texture/we.xpm
EA ./texture/ea.xpm
NO ./texture/no.xpm
SO ./texture/so.xpm
S ./texture/s.xpm
C 0,191,240
F 207,185,151

11111111111111111111111111111111
10000000000000000000000000000001
10000000000000000000000000000001
10100000000000000000000000000001
10100000000000000000000000000001
10100000000000000000000000000001
10100000000000000000000000000001
10100000000000002220000000000001
10100000000000000000000000000001
10100000000000000N00002000000001
10000000000000000000000000000001
10000000000000000000000000000001
10000000000000000000000000000001
100000000000000000000001111111011111
10000000000000000000000000000001
10000000000000000000000000000001
10000000000000000000000000000001
11111111111111111111111111111111
