R 960 540

WE ./texture/we.xpm
EA ./texture/ea.xpm
NO ./texture/no.xpm
SO ./texture/so.xpm
S ./path_to_the_sprite_texture
C 128,128,255
F 212,80,28

11111111111111111111111111111111
10000000000000000000000000000001
10000000000000000000000000000001
10000000000000000000000000000001
10000000000000000000000000000001
10000000000000000000000000000001
10000000000000000000000000000001
10000000000000000000000000000001
100000000000000E0000000000000001
10000000000000000000000000000001
10000000000000000000000000000001
10000000000000000000000000000001
10000000000000000000000000000001
10000000000000000000000000000001
10000000000000000000000000000001
10000000000000000000000000000001
10000000000000000000000000000001
11111111111111111111111111111111
