R 800 800


WE ./texture/we.xpm
EA ./texture/ea.xpm
NO ./texture/no.xpm
SO ./texture/so.xpm
S ./texture/s.xpm
C 0,191,240
F 207,185,151


11111111111111111111111111111111
12020202020202020202020202020201
12020202020202020202020202020201
12020202020202020202020202020201
12020202020202020202020202020201
12020202020202020202020202020201
1200000000000000020000W000000001
10000000000000000100000000000001
10000000000000000000000000000001
10000000000000000000000000000001
10000000000000000000000000000001
10000000000000000000000000000001
10000000000000000000000000000001
10000000000000000000000111111101
10000000000000000000000000000001
10000000000000000000000000000001
10000000000000000000000000000001
11111111111111111111111111111111
