R 1000 1000
EA ./textures/ea.xpm
WE ./textures/we.xpm
SO ./textures/so.xpm
NO ./textures/no.xpm
S ./textures/doosoo.xpm
C 66,194,240
F 156,122,87


111111111111111111111111111
100000000000000000000000001
100000000000000000000000001
100000000000000000000000001
100011111111111111111110001
100012222222222222222210001
100012222222222222222210001
100012222222222222222210001
100012222222222222222210001
100012222222222222222210001
100012222222222222222210001
100012222222222222222210001
100012222222222222222210001
100012222222222222222210001
100011111111000111111110001
100000000000000000000000001
10E000000000000000000000001        11111111111
100000000000000000000000001        12222222221 
111111111111111111111111111        12222222221
1111111111111111111111111111111111110002222221
1000000000000000000000000000000000000002222221
1111111111111111111111111111111111110002222221
                                   12222222221
                                   12222222221
                                   11111111111
