R 802 802



WE ./texture/we.xpm
EA ./texture/ea.xpm
NO ./texture/no.xpm
SO ./texture/so.xpm
S ./texture/s.xpm
C 0,191,240
F 207,185,151

11111111111111111111111111111111
10200000002000000000000000000001
10200000000000000200000000000001
10200000000000000000000000000001
10200000000000000000000000000001
100000000000000000000W0000000001
10000000000000000200000000000001
10000000000000002120000000000001
10000000000000000200000000000001
10000000000000000000000000000001
10000000000000000000000000000001
10000000000000000000000000000001
10000000000000000000000000000001
10000000000000000000000111111101
10000000000000000000000000000001
10000000000000000000000000000001
10000000000000000000000000000001
11111111111111111111111111111111
