R 1000 1000
EA ./textures/ea.xpm
WE ./textures/we.xpm
SO ./textures/so.xpm
NO ./textures/no.xpm
S ./textures/s.xpm
C 100,190,240
F 180,185,150


11111111111111111111
10000000000000000001
10212121222222222201
10000000000000000001
10000000000000000001
10000000000000000001
10000000000000000001
10000000000000000001
10000000000000000001
10000000000000000001
10000000000000000001
10000000000000000001
10000000000000000001
10000000000000000001
10000000000000000001
10000000000000000001
10000000000000000001
10000000000000000001
10E00000000000000001
10000000000000000001
11111111111111111111
