R 500 500
EA ./textures/ea.xpm
WE ./textures/we.xpm
SO ./textures/so.xpm
NO ./textures/no.xpm
S ./textures/s.xpm
C 66,194,240
F 156,122,87

111111111111111111111
100000000000000000001
102222222222222222201
100000000000000000001
100000000000000000001
100000000000000000001
100000000000000000001
100000000000000000001
100000000000000000001
100000000001111111111
100000000000000000001
100000000000000000001
100000000000000000001
100000000000000000001
100000000000000000001
100000000000000000001
100000000000000000001
1000000000N0000000001
100000000000000000001
100000000000000000001
100000000000000000001
111111111111111111111